SERAIAH	西萊雅
SAMGAR-NEBO	三甲尼波
THEUDAS	丟大
DIONYSIUS	丟尼修
DIOTREPHES	丟特腓
DEUEL	丟珥
NAAMAN	乃縵
ADIN	亞丁
ANER	亞乃
ATHALIAH	亞他利雅
ATARAH	亞他拉
ATHAIAH	亞他雅
ABEL	亞伯
ABEDNEGO	亞伯尼歌
ABDI	亞伯底
ABRAHAM	亞伯拉罕
ABDEEL	亞伯疊
ABRAM	亞伯蘭
ABDON	亞伯頓
AHOAH	亞何亞
AHOLIAB	亞何利亞伯
AHLAI	亞來
AMON	亞們
AARON	亞倫
ARIEL	亞列
ARELI	亞列利
ABIEL	亞別
ARIDAI	亞利代
ARIEL	亞利伊勒
ARISTOBULUS	亞利多布
ARIDATHA	亞利大他
ARIEH	亞利耶
ARISAI	亞利賽
ALEXANDER	亞力山大
ATHLAI	亞勒
ARD	亞勒
ALVAN	亞勒文
ALVAH	亞勒瓦
ALPHAEUS	亞勒腓
AUGUSTUS	亞古士督
AGUR	亞古珥
ACHISH	亞吉
AHAB	亞哈
AHARAH	亞哈拉
AHOAZ	亞哈斯
AHOAZIAH	亞哈謝
AHASAI	亞哈賽
AHASUERUS	亞哈隨魯
AHARHEL	亞哈黑
ARETAS	亞哩遠
AGEE	亞基
ARCHIPPUS	亞基布
AGRIPPA	亞基帕
ARCHELAUS	亞基老
ADONIKAM	亞多尼干
ADONI-BEZEK	亞多尼比色
ADONI-ZEDEC	亞多尼洗德
ADONIRAM	亞多尼蘭
ADONIJAH	亞多尼雅
ADORAM	亞多蘭
ADAH	亞大
ADALIA	亞大利雅
ADAIAH	亞大雅
ATTAI	亞太
ANAIAH	亞奈雅
ASHBEL	亞實別
ASHKENAZ	亞實基拿
AQUILA	亞居拉
ARBA	亞巴
AHI	亞希
AHIEZER	亞希以謝
AHITHOPHEL	亞希多弗
AHIAH	亞希幔
AHILUD	亞希律
AHIHUD	亞希忽
AHIRA	亞希拉
AHINADAB	亞希拿達
AHIMOTH	亞希摩
AHISAMACH	亞希撒抹
AHINOAM	亞希暖
AHIAM	亞希暗
AHISHAHAR	亞希沙哈
AHISHAR	亞希煞
AHIMAAZ	亞希瑪斯
AHIKAM	亞希甘
AHITUB	亞希突
AHIMELECH	亞希米勒
AHIO	亞希約
AHIRAM	亞希蘭
AHIJAH	亞希雅
ASAIAH	亞帥雅
ACHAN	亞干
AKAN	亞干
ADDI	亞底
ADINO	亞底挪
AROD	亞律
ADER	亞得
ADRIEL	亞得列
ADRAMMELECH	亞得米勒
ADBEEL	亞德別
AZEL	亞悉
ASSIR	亞惜
AHUZZATH	亞戶撒
AHUZAM	亞戶散
AHUMAI	亞戶買
AZOR	亞所
AMAL	亞抹
ARA	亞拉
ARAH	亞拉
ARAD	亞拉得
ALAMETH	亞拉篾
ADATHA	亞拔他
ANATH	亞拿
ANAH	亞拿
ANNA	亞拿
ANANIAS	亞拿尼亞
ANATHOTH	亞拿突
ARTEMAS	亞提馬
ARMONI	亞摩尼
AMOS	亞摩斯
AMOZ	亞摩斯
ALMODAD	亞摩答
AZAZ	亞撒
ASA	亞撒
ASAREEL	亞撒列
AZARAEL	亞撒利
AZARIAH	亞撒利雅
AZAZIAH	亞撒細雅
AZAZIAH	亞撒西雅
ASAIAH	亞撒雅
ASAHEL	亞撒黑
AZANIAH	亞散尼
APHIAH	亞斐亞
AZRIEI	亞斯列
AZRIKAM	亞斯利干
ASPATHA	亞斯帕他
ASRIEL	亞斯烈
AZMAVETH	亞斯瑪威
AZMAVETH	亞斯瑪弗
ASNAPPER	亞斯那巴
ASHUR	亞施戶
ASHPENAZ	亞施毗拿
ASHVATH	亞施法
ASSHURIM	亞書利
ASHVATH	亞木
ABIEL	亞比
ABIAH	亞比亞
ABIATHAR	亞比亞他
ABIASAPH	亞比亞撒
ABIALBON	亞比亞本
ABIHAIL	亞比亥
ABITAL	亞比他
ABIEZER	亞比以謝
ABIDAN	亞比但
APELLES	亞比利
ABIDAH	亞比大
ABIJAM	亞比央
ABIHAIL	亞比孩
ABHUD	亞比忽
ABIHU	亞比戶
ABINADAB	亞比拿達
ABINOAM	亞比挪菴
ABISHUA	亞比書
ABISHAG	亞比煞
ABIUD	亞比玉
ABIMAEL	亞比瑪利
ABITUB	亞比突
ABISHAI	亞比篩
ABIMELECH	亞比米勒
ABIRAM	亞比蘭
ABIGAIL	亞比該
ABISHUR	亞比述
ABIJAH	亞比雅
ABDON	亞比頓
ARPHAXAD	亞法撒
APOLLOS	亞波羅
ATER	亞特
ARGOB	亞珥歌伯
ARNAN	亞珥難
AHIAN	亞現
AMARIAH	亞瑪利亞
AMARIAH	亞瑪利雅
AMALEK	亞瑪力
AMASHAI	亞瑪帥
AMASA	亞瑪撒
AMASIAH	亞瑪斯雅
AMAZIAH	亞瑪謝
AMASAI	亞瑪賽
AGAG	亞甲
ADAM	亞當
ARIOCH	亞畸
ADIEL	亞疊
ADINA	亞第拿
ADIEL	亞第業
ADLAI	亞第賚
AMIASIEL	亞米
AMMIEL	亞米利
AMITTAI	亞米太
AMMIHUD	亞米忽
AMMINADAB	亞米拿達
AMMISHADDAI	亞米沙代
ARODI	亞羅底
APPHIA	亞腓亞
AHLAI	亞萊
ASIEL	亞薜
ASAPH	亞薩
AZAREEL	亞薩列
AZALIAH	亞薩利
ASARELAH	亞薩利拉
ARAN	亞蘭
ARAM	亞蘭
AZIZA	亞西撒
ASENATH	亞西納
ASHER	亞設
ACHAICUS	亞該古
ANUB	亞諾
AKKUB	亞谷
AHBAN	亞辨
AGABUS	亞迦布
APPAIM	亞遍
ATAD	亞達
ADDAR	亞達珥
ARTAXERXES	亞達薛西
ASYNCRITUS	亞遜其土
ANNAS	亞那
ARISTARCHUS	亞里達古
ACHIM	亞金
AJAH	亞雅
ARZA	亞雜
ANAN	亞難
ANANIAH	亞難尼
ACHBOR	亞革波
AHER	亞黑
ALLON	亞龍
ISHUAH	亦施瓦
ISUI	亦施韋
ISCAH	亦迦
TIMNA	亭納
TABRIMON	他伯利們
TABEEL	他別
TAREA	他利亞
TA-HATH	他哈
TERAH	他拉
TELAH	他拉
THAR-SHISH	他施
TARSHISH	他施斯
TAPPUAH	他普亞
TABEAL	他比勒
TA-PHATH	他法
TAMAR	他瑪
TAHAN	他罕
THAHASH	他轄
ITHAMAR	以他瑪
EBED-MELECH	以伯米勒
ILAI	以來
ELON	以倫
ELEAD	以列
EBED	以別
ERI	以利
ELI	以利
ILI	以利
ELIENAI	以利乃
ELIAH OR ELIJAH	以利亞
ELIATHAH	以利亞他
ELIASHIB	以利亞實
ELASAH	以利亞撒
ELEAZAR	以利亞撒
ELIAKIM	以利亞敬
ELEASAH	以利亞薩
ELIAKIM	以利亞金
ELIEZER	以利以謝
ELIHOREPH	以利何烈
ELIKA	以利加
ELKANAH	以利加拿
ELPAAL	以利巴力
ELIHU	以利戶
ELIAB	以利押
ELNATHAN	以利拿單
ELZAPHAN	以利撒反
ELIZAPHAN	以利撒番
ELIPHELEH	以利斐利戶
ELISHUA	以利書亞
ELIEL	以利業
ELISHA	以利沙
ELISHAH	以利沙
ELISABETH	以利沙伯
ELISHEBA	以利沙巴
ELISHAPHAT	以利沙法
ELISHAMA	以利沙瑪
ELIPHAZ	以利法
ELIPHELET	以利法列
ELIPHAL	以利法勒
ELIMELECH	以利米勒
ELIOENAI	以利約乃
ELIZUR	以利蓿
ELZABAD	以利薩巴
ELIDAD	以利達
ELIJAH	以利雅
ELIAHBA	以利雅哈巴
ELIADA	以利雅大
ELIASAPH	以利雅薩
ELDAAH	以勒大
ENAN	以南
ELIMAS	以呂馬
ITTAI	以太
EZER	以察
ESHCOL	以實各
ESHTEMOA	以實提摩
ISHBI-BENOB	以實比諾
ISHMAEL	以實瑪利
ESHMAIAH	以實買雅
AENEAS	以尼雅
EPAPHRAS	以巴弗
EPAPHRODITUS	以巴弗提
EBAL	以巴錄
EHI	以希
EPHOD	以弗
EPHER	以弗
EPHRON	以弗崙
EPHLAL	以弗拉
EPICUREANS	以彼古羅
ELIUD	以律
EDER	以得
EHUD	以忽
IRA	以拉
ELAH OR ELAM	以拉
ELADAH	以拉大
ERASTUS	以拉都
EPAENETUS	以拜尼土
IRAD	以拿
ENOS	以挪士
ESAU	以掃
ETHAN	以探
ELMODAM	以摩當
ISSAC	以撒
ESARHADDON	以撒哈頓
ELAM	以攔
EPHAI	以斐
EZRI	以斯利
ESLI	以斯利
IZHAR	以斯哈
ESTHER	以斯帖
EZRA	以斯拉
EZBON	以斯本
EVI	以未
EVIL-MERODACH	以未米羅達
EDOM	以東
EGLAH	以格拉
IBZAN	以比讚
EBIASAPH	以比雅撒
EPHAH	以法
EPHRATAH	以法他
ELPALET	以法列
EPHRAIM	以法蓮
ITHREAM	以特念
ITHRA	以特拉
IR	以珥
IGAL	以甲
ISHI	以示
EHUD	以笏
EKER	以結
ISRAEL	以色列
EZER	以薛
ISSACHAR	以薩迦
IRAM	以蘭
IRAN	以蘭
EZEKIEL	以西結
ESHEK	以設
ENOCH	以諾
EZER	以謝
EZER	以謝珥
ISAIAH	以賽亞
IRU	以路
IGAL	以迦
ICHABOD	以迦博
ELIAM	以連
ITHIEL	以鐵
JEEZER	伊以謝
ELIAKIM	伊利亞敬
ELNAAM	伊利拿安
ELUZAI	伊利烏賽
ELDAD	伊利達
IRIJAH	伊利雅
ELHANAN	伊勒哈難
IGDAIAH	伊基大利
IPHEDEJAH	伊弗底雅
IDBASH	伊得巴
ETHNAN	伊提南
JEZLIAH	伊斯利亞
IZRAHIAH	伊斯拉希
JEZRAHIAH	伊斯拉希雅
EZBAI	伊斯拜
ISMACHIAH	伊斯瑪基雅
ISHMAIAH	伊斯瑪雅
ESHTON	伊施屯
ISHBAK	伊施巴
ISPAH	伊施巴
ESH-BAAL	伊施巴力
ISHBOSHETH	伊施波設
ISHPAN	伊施班
ISHMA	伊施瑪
ISHMERAI	伊施米萊
ISHOD	伊施荷
ESHBAN	伊是班
IBNEJAH	伊比尼雅
IZRI	伊洗利
ETHNI	伊特尼
ITHMAH	伊特瑪
EDEN	伊甸
EGLON	伊磯倫
ISHIJAH	伊示雅
ISHIAH	伊示雅
JETUR	伊突
BETH-LEHEM	伯利恒
BETH-RAPHA	伯拉巴
BLASTUS	伯拉斯都
BELTSHAZZAR	伯提沙撒
BELSHAZZAR	伯沙撒
PROCHORUS	伯羅哥羅
BETH-GADER	伯迦得
SHIMRON	伸崙
SHIMSHAI	伸帥
DAN	但
DANIEL	但以利
DANIEL	但以理
DIDYMUS	低土馬
DIPHATH	低法
DEMETRIUS	低米丟
HORI	何利
HOTHAM	何坦
HODAIAH	何大雅
HOHAM	何威
HOBAB	何巴
HOPHNI	何弗尼
HOTHIR	何提
HOSHAMA	何沙瑪
HOSHAIAH	何沙雅
HOSHEA	何細亞
HOSAH	何薩
HOSHEA	何西阿
HOSAI	何賽
HODEVAH	何達威
HODAVIAH	何達威雅
JAMBRES	佯庇
IBRI	使比利
BEN	便
BEN-ABINADAB	便亞比拿達
BEN-AMMI	便亞米
BEN-HAIL	便亥伊勒
BEN-ONI	便俄尼
BEN-HANAN	便哈南
BEN-HADAD	便哈達
BEN-GEBER	便基別
BEN-HESED	便希悉
BEN-DEKAR	便底甲
BEN-HUR	便戶珥
BEN-ZOHETH	便梭黑
BENJAMIN	便雅憫
OBED	俄備得
OBED-EDOM	俄別以東
ONAN	俄南
PBADIAH	俄巴底
OBADIAH	俄巴底亞
OBADIAH	俄巴底雅
OBADIAH	俄巴第雅
OBAL	俄巴路
OPHRAH	俄弗拉
OTHNI	俄得尼
ODAD	俄德
ORPAH	俄珥巴
OREB	俄立
OCRAN	俄蘭
OTHNIEL	俄陀聶
PAUL	保羅
BEERI	備利
BEERAH	備拉
BAKBUKIAH	八布迦
PATROBOS	八羅巴
LEAH	利亞
REAIAH	利亞雅
REI	利以
REELAIAH	利來雅
REGEM	利健
LIKHI	利克希
REHOB	利合
LEHABIM	利哈比
rehabiah	利哈比雅
regem-melech	利堅米勒
LINUS	利奴
REHUM	利宏
REZIA	利寫
REBA	利巴
LEBBAEUS	利巴
LEBANAH	利巴拿
RESHEPH	利悉
lemuel	利慕伊勒
RIBAI	利拜
RHESA	利撤
RIZPAH	利斯巴
LEVI	利未
REZIN	利汎
RIPHATH	利法
REPHAH	利法
REPHAEL	利法益
REPHAIAH	利法雅
LEUMMIM	利烏米
REMALIAH	利瑪利
RECHAB	利甲
REBECCA OR REBEKAH	利百加
REKEM	利肯
RECHAH	利迦
LECAH	利迦
REZON	利遜
letushim	利都是
REKEM	利金
RAKEM	利金
CAREAH	加利亞
CARPUS	加布
KALLAI	加萊
BOANERGES	半尼其
HEPHZIBAH	協西巴
SAMSON	參孫
SANBALLAT	參巴拉
EUNlCE	友尼基
EUBULUS	友布羅
EUODIAS	友阿爹
CYRUS	古列
CUSH	古實
GUNI	古尼
KUSHAIAH	古沙雅
CHUSHAN-RISHATHAIM	古珊利薩田
CUSHI	古示
KORE	可利
KORAH	可拉
STEPHEN	司提反
STEPHANAS	司提反
COL-HOZEH	各荷西
PHARAOH-HOPHRA	合弗拉
GIDDEL	吉德
GIBBAR	吉罷珥
ham	含
ur	吾珥
lydia	呂底亞
lysanias	呂撒聶
lysias	呂西亞
HATACH	哈他革
HAKKTAN	哈加坦
HAREPH	哈勒
HAGGITH	哈及
HAKUPHA	哈古巴
HAKKOZ	哈哥斯
HAGGI	哈基
HAGGERI	哈基利
HAGGIAH	哈基雅
HATHATH	哈塔
HADORAM	哈多蘭
HADAR	哈大
HADAREZER	哈大利謝
HADADEZER	哈大底謝
HADOSSAH	哈大沙
HANUN	哈嫩
HARNEPHER	哈尼弗
HARUM	哈崙
HABAZINIAH	哈巴洗泥雅
HABAKKUK	哈巴谷
HABAIAH	哈巴雅
HATITA	哈底大
HADLAI	哈得萊
HARHUR	哈忽
HAZELELPONI	哈悉勒玻尼
HAMUTAL	哈慕他
HAMOR	哈抹
HARIPH	哈拉
HASHBADANA	哈拔大拿
HANNAH	哈拿
HANANI	哈拿尼
HANANIAH	哈拿尼亞
HANANIAH	哈拿尼雅
HANANIAH	哈拿蔑
HATIPHA	哈提法
HAMMOLEKETH	哈摩利吉
HASADIAH	哈撒底
HASRAH	哈斯拉
HAMAN	哈曼
HATTIL	哈替
HEMATH	哈末
HAKKOZ	哈歇斯
HAMUEL	哈母利
HAMUL	哈母勒
HARSHA	哈沙
HASHABNIAH	哈沙尼
HASHABNAH	哈沙拿
HASHABIAH	哈沙比雅
HARBONA	哈波拿
HARHAIAH	哈海雅
HASHEM	哈深
HARHAS	哈珥哈斯
HARIM	哈琳
HAZO	哈瑣
HAGAB	哈甲
HATTUSH	哈突
HAMMELECH	哈米勒
HAMMEDATHA	哈米大他
HAROEH	哈羅以
HALOHESH	哈羅黑
HAVILAH	哈腓拉
HASHUBAH	哈舒巴
HAZIEL	哈薛
HAZAEL	哈薛
HAZARMAVETH	哈薩瑪非
HASUPHA	哈蘇巴
HARAN	哈蘭
HASENUAH	哈西努
SENUAH	哈西努亞
HASSENAAH	哈西拿
HAGGAI	哈該
HANOCH	哈諾
HAKUPHA	哈谷巴
HAZAIAH	哈賽雅
HARUMAPH	哈路抹
HAAHASHTARI	哈轄斯他利
HACHALIAH	哈迦利亞
HAGABA	哈迦巴
HASHUB	哈述
HADAD	哈達
HAPPIZZEZ	哈闢悉
HANAN	哈難
HACHMONI	哈革摩尼
HASHUM	哈順
HARUZ	哈魯斯
CORNELIUS	哥尼流
CONIAH	哥尼雅
COZ	哥斯
COZBI	哥斯比
COSAM	哥桑
KOLAIAH	哥賴雅
KOHATH	哥轄
SHEMEBER	善以別
RAHAB	喇合
TANHUMETH	單戶蔑
OG	噩
TUBALO	土 巴
TUBALCAIN	土八該隱
TRYPHOSA	土富撒
DRUSLLA	土西拉
TRYPHENA	土非拿
KEILAH	基伊拉
GILEAD	基列
GEBER	基別
KELITA	基利他
CRISPUS	基利司布
CHILEAB	基利押
GENUBATH	基努拔
GEHAZI	基哈西
GESHEM	基善
KETURAH	基土拉
KISH	基士
GEDOR	基多
GIDEONI	基多尼
GEDALIAH	基大利
GIDDALTI	基大利提
CHEDORLAOMER	基大老瑪
GETHER	基帖
KEDEMAH	基底瑪
GERA	基拉
CHELAL	基拉
GILALAI	基拉萊
KELAIAH	基拉雅
CHENANI	基拿尼
CHENANIAH	基拿尼雅
CHENAANAH	基拿拿
KITTIM	基提
CHISLON	基斯倫
GISPA	基斯帕
GIDEON	基旬
KEMUEL	基母利
GIBEA	基比亞
KEZIA	基洗亞
GESHAM	基珊
GEMALLI	基瑪利
GEMARIAH	基瑪利雅
KISHI	基示
GINATH	基納
KENAZ	基納斯
KEROS	基綠
CHELUB	基綠
CHESED	基薛
CHERAN	基蘭
CHELUBAI	基路拜
CHILION	基連
KEREN-HAPPUCH	基連哈樸
KEDAR	基達
SETH	塞特
BILGAI	壁該
SCEVA	士基瓦
SERGIUS PAULU	士求保羅
SHIMON	士門
EVE	夏娃
HAGAR	夏甲
DORCAS	多加
DODANIM	多單
DODAVAH	多大瓦
TOBIAH	多比雅
TOBIJAH	多比雅
DOEG	多益
THOMAS	多馬
DELILAH	大利拉
DARIUS	大利烏
DATHAN	大坍
DARA	大拉
TABITHA	大比大
DAVID	大衛
DAMARIS	大馬哩
NUN	嫩
ON	安
ANDRONICUS	安多尼古
ANDREW	安得烈
ANTIPAS	安提帕
ANTOHIJAH	安陀提雅
MIKLOTH	密基羅
MILCAH	密迦
NYMPHAS	寧法
NIMSHI	寧示
NIMROD	寧錄
NEBAT	尼八
NERI	尼利
NEREUS	尼利亞
NERIAH	尼利亞
NEARIAH	尼利雅
NECHO	尼哥
NEKODA	尼哥大
NICODEMUS	尼哥底母
NICOLAS	尼哥拉
NEDABIAH	尼大比雅
NEHUM	尼安
NEBUZARADAN	尼布撒拉旦
NEBUSHASBAN	尼布沙斯班
NEBUCHADNEZZAR	尼布甲尼撒
NEHEMIAH	尼希米
NEBAI	尼拜
NEBAJOTH	尼拜約
NETHANIAH	尼探雅
NEPHEG	尼斐
NEPHUSIM	尼普心
NEMUEL	尼母利
NER	尼珥
NERGAL-SHAREZER	尼甲沙利薛
NEZIAH	尼細亞
NIGER	尼結
NEHUSHTA	尼護施他
NICANOR	尼迦挪
QUIRINIUS	居里扭
BARIAH	巴利亞
BAALIS	巴利斯
BAAL	巴力
BALAK	巴勒
BAAL-HANAN	巴勒哈南
BAKBUK	巴卜
PAHATH-MOAB	巴哈摩押
BARTHOLOMEW	巴多羅買
BASHEMATH	巴實抹
BANI	巴尼
BARTlMAEUS	巴底買
BARAK	巴拉
BAARA	巴拉
PALAL	巴拉
BALADAN	巴拉但
MERODACH-BALADAN	巴拉但
BARCHIAS	巴拉加
BARABBAS	巴拉巴
BARACHEL	巴拉迦
BAANAH	巴拿
BARNABAS	巴拿巴
BANSABAS	巴撒巴
PASHUR	巴施戶珥
BARKOS	巴柯
BAASHA	巴沙
BAZLUTH	巴洗律
PARSHANDATHA	巴珊大他
RAVAI	巴瓦伊
PARMENAS	巴米拿
BAR-JONA	巴約拿
BAR-JESU	巴耶穌
PASACH	巴薩
BALAAM	巴蘭
RASEAH	巴西亞
BARZILLAI	巴西萊
BAASEIAH	巴西雅
PAROSH	巴錄
BARUCH	巴錄
PADON	巴頓
BUKKI	布基
BUKKIAH	布基雅
BUNNI	布尼
BUNAH	布拿
BUZ	布斯
PUDENS	布田
BUZI	布西
hiel	希伊勒
heber	希伯
hebron	希伯倫
helon	希倫
hillel	希列
heber	希別
helez	希利斯
helek	希勒
hilkiah	希勒家
helkai	希勒愷
hiddai	希太
heman	希幔
hepher	希弗
herod	希律
hezir	希悉
hirah	希拉
helah	希拉
henadad	希拿達
hezron	希斯倫
hezron	希斯倫
hezro	希斯羅
hezro	希斯萊
hezion	希旬
heber	希百
heled	希立
herodion	希羅天
herodias	希羅底
hiram	希蘭
hizki	希西基
hezekiah	希西家
hizkijah	希西家
hegai	希該
helem	希連
heli	希里
PALTITE	帕勒提
PALTI	帕提
PATHRUSIM	帕斯魯細
PARMASHTA	帕瑪斯他
PARNACH	帕納
PAGIEL	帕結
PAARAI	帕萊
PARUAH	帕路亞
PALTIEL	帕鐵
TERTULLUS	帖土羅
CANDACE	干大基
JUSHAB-HSED	干沙希悉
DIBRI	底伯利
DEDAN	底但
DINAH	底拿
DEBORAH	底波拉
DISHAN	底珊
DEBIR	底璧
DEKAR	底甲
DEMETRIUS	底米丟
TIMAEUS	底買
DISHON	底順
DUMAH	度瑪
PHUT	弗
PHLEGON	弗勒干
MIBHAR	彌伯哈
MIKNEIAH	彌克尼雅
MICAH	彌迦
BETHUEL	彼土利
PETER	彼得
PERSIS	彼息氏
PILATE	彼拉多
SYNTYCHE	循都基
TERTIUS	德丟
DIKLAH	德拉
ZIMRIO	心利
ZIMRAN	心蘭
BIL-SHAN	必珊
PIL-DASH	必達
ZILPAH	悉怕
MEONOTHAL	憫挪太
HUSHIM	戶伸
HURI	戶利
HUL	戶勒
HULDAH	戶勒大
HUPHAM	戶反
HUPPIM	戶品
HUPPlM	戶品
HUSHAH	戶沙
HUSHAM	戶珊
HUR	戶珥
HURAI	戶萊
HURAM	戶蘭
SOPATER	所巴特
SOSTHENES	所提尼
ZERUBBABEL	所羅巴伯
SOLOMON	所羅門
SOSIPATER	所西巴德
MAHALI	抹利
MAGPIASH	抹比押
MACHBENAH	抹比拿
AZBUK	押卜
ARDON	押墩
ABDA	押大
ABNER	押尼珥
ABDI	押底
ADBEEL	押德別
ASNAH	押拿
ADNAH	押拿
ACHSAH	押撒
AZRIKAM	押斯利甘
AZMAVETH	押斯瑪威
AZMAVETH	押斯瑪弗
AZZUR	押朔
JADDUA	押杜亞
ABDIEL	押比疊
ABSALOM	押沙龍
ADMATHA	押瑪他
AZGAD	押甲
ABDON	押頓
RADDAI	拉代
LAEL	拉伊勒
RADSARIS	拉伯撒利
RAD-SHAKEH	拉伯沙基
LADAN	拉但
LAISH	拉億
RAHAM	拉含
REU	拉吳
LAHAD	拉哈
LAHMI	拉哈米
LAADAH	拉大
RAPHU	拉孚
LAZARUS	拉撒路
RAMOTH	拉末
LAPIDOTH	拉比多
RAPHA	拉法
LABAN	拉班
RAAMAH	拉瑪
RAMIAH	拉米
RAAMIAH	拉米
RACHEL	拉結
LAMECH	拉麥
BAKBAKKAR	拔巴甲
BATH-SHUA	拔書亞
BATH-SHEBA	拔示巴
UARTUS	括土
SHIPHTAN	拾弗但
NABOTH	拿伯
NATHANAEL	拿但業
NAOMI	拿俄米
NABAL	拿八
NARCISSUS	拿其數
NAHAM	拿含
NAHATH	拿哈
NAHAMANI	拿哈瑪尼
NAHARI	拿哈萊
NATHAN	拿單
NATHAN-MELECH	拿單米勒
NETHANEEL	拿坦業
MNASON	拿孫
NAAM	拿安
NAPHTALI	拿弗他利
NAARAH	拿拉
NAHBI	拿比
NAAMAH	拿瑪
NADAB	拿答
NAARAI	拿萊
NAGGE	拿該
NAHASH	拿轄
NEPHUSIM	拿非施
NAHSHON	拿順
NAHUM	拿鴻
NAHOR	拿鶴
SAUL	掃羅
TYRANNUS	推喇奴
TYCHICUS	推基古
TILON	提倫
TEBAH	提八
TERESH	提列
TIRIA	提利
TITUS	提多
TEMAN	提幔
TIRAS	提拉
TIMOTHEUS	提摩太
TEHINNAH	提欣拿
TIBNI	提比尼
TIBERIUS	提比留
TEMA	提瑪
TEMENI	提米尼
TELEM	提聯
TIDAL	提達
TIMON	提門
THEOPHILUS	提阿非羅
TIGLATH-PILESER	提革拉毘列色
TIGLATH-PILNESER	提革拉毘尼色
NOAH	揶亞
NOADIAH	揶亞底
NOHAH	揶哈
NOBAH	揶巴
NOGAH	揶迦
NOAH	揶阿
MOLID	摩利
MOAB	摩押
MOZA	摩撒
MOSES	摩西
SALLAI	撒來
ZACCUR	撒刻
ZABDI	撒巴底
ZABDIEL	撒巴第業
ZACCUR	撒布
ZABUD	撒布得
ZABDI	撒底
SAPH	撒弗
SABTAH	撒弗他
SABTECHA	撒弗提迦
ZALMUNNA	撒慕拿
SARAH	撒拉
SHEALTIEL	撒拉鐵
ZABAD	撒拔
SAMUEL	撒母耳
SARGON	撒珥根
SHEMER	撒瑪
ZAAVAN	撒番
ZAPHNATH-PAANEAH	撒發那忒巴內亞
ZADOK	撒督
SHALMANESER	撒縵以色
ZAHAM	撒罕
SALOME	撒羅米
SARAI	撒萊
ZAZA	撒薩
SARSECHIM	撒西金
ZACCHAEUS	撒該
SALU	撒路
SALLU	撒路
ZACHER	撒迦
ZACHARIAH	撒迦利亞
ZACHARIAS	撒迦利亞
ZECHARIAH	撒迦利雅
ZALMON	撒門
SAPPHIRA	撒非喇
SHEAR-JASHUB	施亞雅述
SHIPHRAH	施弗拉
SHITRAI	施提賽
SHILSHAH	施沙
IBSARN	易伯散
LDDO	易多
PUL	普勒
PURAH	普拉
PHUVAH	普瓦
PUAH	普瓦
PUTIEL	普鐵
PUAH	普阿
AMPLIAS	暗伯利
OMRI	暗利
AMNON	暗嫩
AMRAPHEL	暗拉非
AMZI	暗洗
AMMIZABAD	暗米薩拔
AMRAM	暗蘭
AMZI	暗西
HOGLAH	曷拉
SHUAH	書亞
SHUAH	書亞
SUAH	書亞
SHUPHAM	書反
SHUPHAM	書含
SHUPPIM	書品
SHUNI	書尼
SHUBAEL	書巴業
SHUTHELA	書提拉
SHUPPIM	書聘
SHUAL	書阿勒
SHUAH	書雅
SHOHAM	朔含
SHOBAL	朔巴
SHOBAI	朔拜
SHOBI	朔比
SHOBACH OR SHOPHACH	朔法
SHOBEK	朔百
SHOBAB	朔罷
SHOMER	朔默
MAHLI	末力
MACHBONAI	末巴奈
MORDECAI	末底改
PONTIUS PILATE	本丟彼拉多
DODAI	朵代
DODO	朵多
RINNAH	林拿
SAMLAH	桑拉
SO	梭
SODI	梭底
SEORIM	梭琳
ZOHETH	梭黑
GOLIATH	歌利亞
CONANIAH	歌楠雅
GOMER	歌蔑
GOG	歌革
MUPPIM	母平
MUSHI	母示
BEALIAH	比亞利雅
BEDAN	比但
BERED	比列
BERI	比利
BEERl	比利
BERIAH	比利亞
BERECHIAH	比利家
BERECHIAH	比利迦
BEELIADA	比利雅大
PEKAH	比加
PEKAHlAH	比加轄
PELETH	比勒
BlLHAN	比勒罕
BlLDAD	比勒達
BICHRI	比基利
PEDAHZLUR	比大蓿
PEDAHEL	比大黑
PINON	比嫩
BENlNU	比尼努
BEDEIAH	比底雅
BEOR	比弭
BEZE	比悉
BESODEIAH	比所玳
BERA	比拉
BELA	比拉
BEERI	比拉
BERACHAH	比拉迦
BERAlAH	比拉雅
BEBAI	比拜
BENAIAH	比拿亞
BENAIAH	比拿雅
BENO	比挪
BlTHIAH	比提雅
BEZALEEL	比撒列
BRZAVlTH	比撒威
BlZTHA	比斯他
LBlSHLAM	比施蘭
BECHORATH	比歌拉
BIRSHA	比沙
BECHER	比結
BERODACH-BALADAN	比羅達巴拉但
BESAI	比賽
BEZAI	比賽
PERUDAORPERIDA	比路大
BADAD	比違
BlGTHA	比革他
PETHAHIAH	毘他希雅
PILEHA	毘利哈
PERESH	毘利施
PELET	毘力
PILTAI	毘勒太
PETHUEL	毘土珥
PEDAIAH	毘大雅
PENINNAH	毘尼拿
PENUEL	毘弩伊勒
PELALIAH	毘拉利
PELATIAH	毘拉提
PITHON	毘敦
PISPAH	毘斯巴
PEULIETHAI	毘烏利大
PELAIAH	毘萊雅
PIRAM	毘蘭
SHAAPH	沙亞弗
sheleph	沙列
SHAREZER	沙利色
SHALMAN	沙勒幔
SHAHARAIM	沙哈連
shage	沙基
SHAVSHA	沙威沙
ahage	沙密
shallun	沙崙
SHADRACH	沙得拉
shelah	沙拉
sharar	沙拉
SHAMMUA	沙母亞
SHABBETHAI	沙比太
SHAPHAT	沙法
SHASHAK	沙煞
SHAMMAH	沙瑪
SHAMA	沙瑪
SHAASHGAZ	沙甲
SACAR	沙甲
SHAPHAM	沙番
SHAPHAN	沙番
SHAMMAI	沙買
SHARAI	沙賴
SHASHAI	沙賽
SHACHIA	沙迦
SHAMED	沙麥
SHALLUM	沙龍
HOD	河得
GUNI	沽尼
PHANUEL	法內力
PELEG	法勒
PERAZ	法勒斯
PHARAOH-NECHOH	法老尼哥
PHALLU	法路
BOCHERU	波基路
POTIPHAR	波提乏
POTI-PHERA	波提非拉
PORCIUS-FESTUS	波求非斯都
BOHAN	波罕
BOAZ	波阿斯
ZIPHION	洗分
ZERETH	洗列
ZELEK	洗勒
ZILTHAI	洗勒太
ZIBA	洗巴
ZILLAH	洗拉
ZIBIAH	洗比雅
ZEPHO	洗玻
ZEROR	洗羅
ZIPHION	洗非芸
ZEREDA	洗魯阿
ZERUIAH	洗魯雅
REUBEN	流便
REUEL	流珥
REUMAH	流瑪
DIBLAIM	滴拉音
HANNIEL	漢尼業
HANNIEL	漢聶
URIEL	烏列
URI	烏利
URIAH	烏利亞
UTHAI	烏太
UNNI	烏尼
ULLA	烏拉
UZZAH	烏撒
UZZAH	烏斯
UCAL	烏甲
UEL	烏益
UZZIEL	烏薛
UZAL	烏薩
ULAM	烏蘭
UZZI	烏西
UZZIA	烏西亞
UZZIAH	烏西雅
UZAI	烏賽
TIRHANAH	特哈加
TIRHANAH	特哈拿
TIRHAKAH	特瓦
TROPHIMUS	特羅非摩
JUBAL	猶八
JULIA	猶利亞
JUSTUS	猶士都
JUDA	猶大
JUDAH	猶大
JUDAS	猶大
JUNIAS	猶尼亞
JEHUDI	猶底
JOELAH	猶拉
EUTYCHUS	猶推古
JULIUS	猶流
JUDITH	猶滴
JEHUCAL	猶甲
POCHERETH OF ZEBAIM	玻黑列哈斯巴音
SHAMHUTH	珊合
SHAMMA	珊瑪
AHSMSHERAI	珊示萊
SHAGAR	珊迦
ER	珥
SOTAI	瑣太
HASSOPHERETH	瑣斐列
ZOBEBAH	瑣比巴
ZOPHAR	瑣法
ZOPHAH	瑣法
ZOHAR	瑣轄
MATTANIAH	瑪他尼
MATTATHIAS	瑪他提亞
MATTITHIAH	瑪他提雅
MEDIA	瑪代
MAOCH	瑪俄
MAHLON	瑪倫
MAHALALEL	瑪勒列
MAGOG	瑪各
MACHIR	瑪吉
MAHATH	瑪哈
MAHALATH	瑪哈拉
MAHAZIOTH	瑪哈秀
MAHARAI	瑪哈萊
METHUSHAEL	瑪土撒利
MATHUSELAH	瑪土撒拉
MATTAN	瑪坦
MACHI	瑪基
MAGDILEL	瑪基疊
MALCHIRAM	瑪基蘭
MALCHIJAHOR MALCHIAH	瑪基雅
MATTHAT	瑪塔
MAADIAH	瑪底雅
MAATH	瑪押
MAHLAH	瑪拉
MARA	瑪拉
MALACHI	瑪拉基
MALCAM	瑪拉干
MACHNADEBAI	瑪拿底拜
MANASSEH	瑪拿西
MANAHATH	瑪拿轄
MANOAH	瑪挪亞
MATTANIAH	瑪探雅
MASSA	瑪撒
MAAZ	瑪斯
MASH	瑪施
MAHOL	瑪曷
MAGOR-MISSAABIB	瑪歌珥米撒畢
MATTENAI	瑪特乃
MATRED	瑪特列
MAADAI	瑪玳
MALCHIEL	瑪結
MALLOTHI	瑪羅提
MAAI	瑪艾
MAAZIAH	瑪西亞
MARSENA	瑪西拿
MAASEAS	瑪西雅
MAHSEIAH	瑪西雅
MAASAI	瑪賽
MAACAH	瑪迦
MALLUCH	瑪鹿
MAHER-SHALAL-HASH-BEZ	瑪黑珥沙拉勒哈施罷斯
BILGAH	璧迦
VASHTI	瓦實提
VANIAH	瓦尼雅
VAJEZATHA	瓦耶撒他
SHIMRI	甲利
CALCOL	甲各
SHIMRATH	甲拉
CARSHENA	甲示拿
KADMIEL	甲篾
CARCAS	甲迦
BIDKAR	畢甲
PYRRHUS	畢羅斯
PRISCILLA	百基拉
BERNICE	百尼基
IKKESH	益吉
ISHBAH	益巴
JETHER	益帖
JIDLAPH	益拉
ITHRAN	益蘭
IBHAR	益轄
JAIR	睚珥
JAIRUS	睚魯
PORATHA	破拉他
CEPHAS	磯法
SHEDEUR	示丟珥
SHEARIAH	示亞利雅
SHEMAR-BOZAI	示他波斯乃
SHALLUM	示冷
SHEBER	示別
SHILHI	示利希
SHELESH	示利斯
SHERESH	示利施
SHEREBIAH	示利比
SHELEMIAH	示利米雅
SHEHARIAH	示哈利
SHEPHUPHAN	示孚汎
SEBA	示巴
SHEBANIAH	示巴尼
SHEAL	示押
SHELAH	示拉
SHENAZAR	示拿薩
SHIZA	示撒
SHISHAK	示撒
SHEMUEL	示母利
SHIMI	示每
SHISHA	示沙
SHEVA	示法
SHEPHATIAH	示法提雅
SHEPHO	示玻
SHESHAN	示珊
SHEMA	示瑪
SHEMAAH	示瑪
SHEMARIAH	示瑪利雅
SHEMAIAH	示瑪雅
SHESHAI	示篩
SHIMEA	示米亞
SHIMRITH	示米利
SHEMIDA	示米大
SHEMATH	示米押
SHEMIRAMOTH	示米拉末
SHEMEAH	示米暗
SHINAB	示納
SHELOMITH	示羅密
SHELOMITH	示羅摩
SHELOMI	示羅米
SHELUMIEL	示路篾
SHECANIAH	示迦尼
SHECANIAH	示迦尼雅
SHETHAR	示達
SHIPHI	示非
ZIBEON	祭便
FORTUNATUS	福徒拿都
LIBNI	立尼
DALAIAH	第來雅
DALAIAH	第萊雅
TABBAOTH	答巴俄
TAHPENES	答比匿
TEMAB	答瑪
MEDAN	米但
MERED	米列
MELEA	米利亞
MIRIAM	米利暗
MEREMOTH	米利末
MERES	米力
MERIB-BAAL	米力巴力
MELECH	米勒
MICHRI	米基立
MESHILLEMITH	米實利密
MESHILLEMOTH	米實利末
MEHETABEL	米希他別
MEHIDA	米希大
MEHETABEEL	米希大別
MEHUMAN	米戶慢
MEHUJAEL	米戶雅利
MESHOBAB	米所巴
MERAB	米拉
MERARI	米拉利
MELATIAH	米拉提
MERAIOTH	米拉約
MILALAI	米拉萊
MERAIAH	米拉雅
MINIAMIN	米拿民
MENAHEM	米拿現
MITHREDATH	米提利達
MIZZAH	米撒
MIZPAR	米斯拔
MISPERETH	米斯毗列
MESHELEMIAH	米施利米雅
MISHMA	米施瑪
MESHULLAM	米書蘭
MEBUNNAI	米本乃
MEMUCAN	米母干
MIBZAR	米比薩
MIBSAM	米比衫
MESHA	米沙
MISHAEL	米沙利
MAZAR	米沙利
MESHACH	米煞
MITHREDATH	米特利達
MISHAM	米珊
MIRMA	米瑪
MICHAL	米甲
MIDIAN	米甸
MESHEZABEEL	米示薩別
MESHULLEMETH	米舒利密
MEZAHAB	米薩合
MESHECH	米設
MICHAIAH	米該亞
MICAH	米迦
MICHAL	米迦
MICHAEL	米迦勒
MEDAD	米達
MIJMIN	米雅民
MEPHIBOSHETH	米非波設
MEHIR	米黑
JOAH	約亞
JOANNA	約亞拿
JOANNA	約亞拿
JORIM	約令
JOEZER	約以謝
JOB	約伯
JOB	約伯
JOGLI	約利
JONAN	約南
JOHA	約哈
JOAHAZ	約哈斯
JEHOAHAZ	約哈斯
JOHANAN	約哈難
JOHOHANAN	約哈難
JOKTAN	約坍
JOTHAM	約坦
JOCHEBED	約基別
JOBAB	約巴
JORKOAM	約干
JOAB	約押
JORAH	約拉
JONAH	約拿
JONATHAN	約拿單
JONADAB	約拿達
JOSABAD	約撒拔
JOZACHAR	約撒甲
JOZEDECH	約撒答
JOZADAK	約撒達
JOKIM	約敬
JOSHBEKASHAH	約施比加沙
JOSHUA	約書亞
JESHOHAIAH	約朔海
JOSHAH	約沙
JOSHAVIAH	約沙未雅
JEHOSAPHAT	約沙法
JEHOSHAPHAT	約沙法
JOKSHAN	約珊
JOEL	約珥
JOSEPH	約瑟
JEHOSHEBA	約示巴
JOSIBIAH	約示比
JOSEPH	約細
JOSIPHIAH	約細斐
JOHN	約翰
JEHOADDAN	約耶但
JOSEPH	約色
JOED	約葉
JEHOZABAD	約薩拔
JEHOZADAK	約薩答
JOHORAM	約蘭
JOSES	約西
JOSIAH	約西亞
JOSHEB-BASSHEBET	約設巴設
JORAI	約賴
JOASH	約阿施
JEHOIAKIM	約雅敬
JEHOIACHIN	約雅斤
JEHOIARIB	約雅立
JOIAKIM	約雅金
ZIA	細亞
ZERESH	細利斯
ZETHAN	細坦
ZETHAM	細坦
ZICHRI	細基利
SHEBUEL	細布業
ZINA	細拿
ZIZAH	細撒
ZIZA	細撒
ZEMIRA	細米拉
VOPHSI	縛西
LOIS	羅以
RODANIM	羅單
LOTAN	羅坍
RHODA	羅大
RUFUS	羅孚
ROSH	羅實
ROMAMTI-EZER	羅幔提以謝
LOT	羅得
REHOBOAM	羅波安
LO-RUHAMAH	羅路哈瑪
ROHGAH	羅迦
LO-AMMI	羅阿米
URBANE	耳巴奴
JEHOIADA	耶何耶大
JEHOADAH	耶何阿達
JEHOIARIB	耶何雅立
JEHIEL	耶利
JERIBAI	耶利拜
JERIMOTH	耶利摩
JEREMOTH	耶利末
JEREMIAH	耶利米
JEREMAI	耶利買
JERIAH	耶利雅
JECAMIAH	耶加米
JEKAMIAH	耶加米雅
JEKAMEAM	耶加面
JERIEL	耶勒
JEKUTHIEL	耶古鐵
JECHOLIAH	耶可利雅
JARHA	耶哈
JEHALELEEL	耶哈和勒
JAHDO	耶哈多
JECONIAH	耶哥尼雅
JEDAIAH	耶大雅
JEPHUNNEH	耶孚尼
JASON	耶孫
JEHIAH	耶希亞
JEHIELI	耶希伊利
JEHDEIAH	耶希底亞
JEHEZEKEL	耶希斯刻
JEHIZKIAH	耶希西家
JETHETH	耶帖
JEDIDAH	耶底大
JEDIDIAH	耶底底亞
JEPHTHAH	耶弗他
JEHU	耶戶
JEHUBBAH	耶戶巴
JERAH	耶拉
JERAHMEEL	耶拉篾
JATHNIEL	耶提聶
JEZANIAH	耶撒尼亞
JESUS	耶數
JESUS JUSTUS	耶數猶士都
JEZREEL	耶斯列
JESHEBEAB	耶是比押
JESHEUAH	耶書亞
JESHURUN	耶書崙
JEDUTHUN	耶杜頓
JEHIEL	耶歇
JEMUEL	耶母利
JEBERECHIAH	耶比利家
JEZEBEL	耶洗別
JEVEL	耶烏利
JEUZ	耶烏斯
JEUSH	耶烏施
JEATERAI	耶特賴
JERIOTH	耶略
JEDIAEL	耶疊
JESHISHAI	耶示篩
JESUS	耶穌
JESAIAH	耶篩亞
JEMIMA	耶米瑪
JAROAH	耶羅亞
JEROBOAM	耶羅波安
JEROHAM	耶羅罕
JEZER	耶色
JEZIEL	耶薛
JESHARELAH	耶薩利拉
JESSE	耶西
JESIMIEL	耶西篾
JESIAH	耶西雅
JEZIAH	耶西雅
JESHER	耶設
JABIN	耶賓
JERUBBAAL	耶路巴力
JERUBBESHETH	耶路比設
JERUSHA	耶路沙
JAREB	耶雷布
HUPPAH	胡巴
PHILIP	腓利
PHILEMON	腓利門
PHILIP	腓力
FELIX	腓力斯
PHYGELUS	腓吉路
PHILETUS	腓理徒
RIMMON	臨門
GEUEL	臼利
SHEERAH	舍伊拉
SHEBNA	舍伯那
CHUZA	苦撒
HOMAM	荷幔
HODUAH	荷第雅
HORAM	荷蘭
JETHRO	葉忒羅
ZATTU	薩土
ZALAPH	薩拉
ZABBAI	薩拜
ZACCAI	薩改
SHAIMAI	薩瑪
SHALMAI	薩買
ZIMMAH	薪瑪
ZURIEL	蘇列
ZURISHADDAI	蘇利沙代
ZUPH	蘇弗
ZUAR	蘇押
SUSANNA	蘇撒拿
ZUR	蘇珥
SUSI	蘇西
RAM	蘭
SIAHA	西亞
ZEEB	西伊伯
SECUNDUS	西公都
SELED	西列
ZERI	西利
SEGUB	西割
ZIHA	西哈
ZIPPORAH	西坡拉
SIHON	西宏
SEBA	西巴
ZEBAH	西巴
ZEBADIAH	西巴第雅
ZEBULON	西布倫
ZEBUL	西布勒
ZEBUDAH	西布大
SETHEUR	西帖
ZEBEDEE	西庇太
ZEDEKIAH	西庇家
ZIPH	西弗
SILAS	西拉
SERAH	西拉
ZERAHIAH	西拉希雅
SENAAH	西拿
SENNACHERIB	西拿基立
ZITHRI	西提利
ZIPPOR	西撥
SISAMAI	西斯買
ZIBIAH	西比亞
ZEBINA	西比拿
SIBBECHAI	西比該
ZIPHAH	西法
SERED	西烈
SEMACHIAT	西瑪迦
ZEPHANIAH	西番亞
ZEPHANIAH	西番雅
ZENAS	西納
SIMEON	西緬
SHIMEON	西緬
ZELOPHEHAD	西羅非哈
SEMEI	西美
SISERA	西西拉
ZETHAR	西達
SIMON	西門
SIMON PETER	西門彼德
SIMEON	西面
SIDON	西頓
SERUG	西鹿
TOHU	託戶
SHESHBAZZAR	設巴薩
HYMEN-EUS	許米乃
CAIAPHAS	該亞法
KENAN	該南
GAIUS	該猶
CAIN	該隱
ETHBAAL	謁巴力
ZERAH	謝拉
COLHOZEH	谷何西
MENNA	買南
HODESH	賀得
BINNUI	賓內
BIMHAL	賓哈
HEN	賢
HETH	赫
LUKE	路加
RUHAMAH	路哈瑪
RUTH	路得
LUD	路德
LUCIUS	路求
BILHAH	辟拉
BIGTHAN	辟探
BILHAN	辟罕
GINNETHO	近頓
GAAL	迦勒
CHALEB	迦勒
CANAAN	迦南
GAZEZ	迦卸
GAHAM	迦含
GAHAR	迦哈
GATAM	迦坦
GADDI	迦底
GADI	迦底
GAD	迦得
GALAL	迦拉
GABBAI	迦拜
GAZZAM	迦散
GASHMU	迦施慕
GAMUL	迦末
GALLIO	迦流
GAMALIEL	迦瑪列
GADDIEL	迦疊
GAREB	迦立
CARMI	迦米
GAZEZ	迦謝
MISHMANNSH	迷斯瑪拿
TATNAI	達乃
TALMON	達們
DALPHON	達分
DARDA	達大
THADDAEUS	達太
DARKON	達昆
TALMAI	達買
TALMAI	達買
NAHUM	那鴻
PUBLIUS	部百流
CHIMHAM	金罕
SHEM	閃
AHOLIBAMAH	阿何利巴瑪
ONAM	阿南
ANIAM	阿尼安
ONESIPHORUS	阿尼色弗
ONESIMUS	阿尼西母
ADNA	阿底拿
OMAR	阿抹
ANANI	阿拿尼
AMOS	阿摩司
AZZAN	阿散
OPHIR	阿斐
OZNI	阿斯尼
OLYMPAS	阿林巴
OBIL	阿比勒
AMMI	阿米
AHOLIBAH	阿荷利巴
AHOLAH	阿荷拉
AZUBAH	阿蘇巴
AKKUB	阿谷
OHAD	阿轄
OREN	阿連
OZEM	阿鮮
OHEL	阿黑
TOAH	陀亞
TOI	陀以
TOLA	陀拉
TOU OR TOI	陀烏
JANAI	雅乃
JAHDAI	雅代
JALON	雅倫
JAEL	雅億
JABAL	雅八
JARED	雅列
JAHLEEL	雅利
JAARESHIAH	雅利西
JASHUBI-LEHEM	雅叔比利恆
JACOB	雅各
JAMES	雅各
JAHATH	雅哈
JAHAZIEL	雅哈悉
JAHZEIAH	雅哈謝
JAAKOBAH	雅哥巴
JASHEN	雅善
JAKEH	雅基
JADA	雅大
JAVAN	雅完
JANNES	雅尼
JAHZERAH	雅希細拉
JACAN	雅干
JAPHETH	雅弗
JAPHLET	雅弗勒
JAZIZ	雅悉
JAMIN	雅憫
JAALAH	雅拉
JARAH	雅拉
JANNA	雅拿
JAASAU	雅掃
JAAZANIAH	雅撒尼亞
JACHIN	雅斤
JASHOBEAM	雅朔班
JABESH	雅比
JABEZ	雅比斯
JADDAI	雅玳
JAHDIEL	雅疊
JARIB	雅立
JAMLECH	雅米勒
JAAZIEL	雅薛
JAHZEEL	雅薛
JALAM	雅蘭
JAASIEL	雅西業
JAAZIAH	雅西雅
JAHMAI	雅買
JASHUB	雅述
JAKIM	雅金
JAARE-OREGIM	雅雷俄珥金
JAPHIA	雅非亞
JADON	雅頓
PHICHOL	非各
PHINEHAS	非尼哈
PHOEBE	非比
PHILOLOGUS	非羅羅古
CHLOE	革來氏
CLEMENT	革利免
CRESCENS	革勒士
CLEOPAS	革流巴
CLEOPHAS	革羅罷
CLAUDIUS	革老丟
CLAUDIUS LYSIAS	革老丟呂西亞
CLAUDIA	革老底亞
GERSHOM	革舜
GERSHON	革順
IMRI	音利
IMLAH	音拉
IMRAH	音拉
JIMNAH	音拿
IMNA	音那
IMMER	音麥
MATTHAN	馬但
MARY	馬利亞
MALCHUS	馬勒古
MARK	馬可
MARTHA	馬大
MATTHEW	馬太
MANAEN	馬念
MATTHIAS	馬提亞
MATTATHA	馬達他
TOB-ADONJIAH	駝巴多尼雅
MELCHI	麥基
MELCHIZEDEK	麥基洗德
MELCHI-SHUA	麥基舒亞
MIZRAIM	麥西
HERESH	黑勒施
HERMOGENES	黑摩其尼
HELDAI	黑玳
HERMES	黑米
HERMAS	黑馬
